######################################################################
#####____##############___#####___##############_____#____####____####
___________########________________#########_________#____#__#_____###
___###_______________________________________________#____####______#_
___#________________###______________________________#____#___________
_________###############__####___########____________#____#__________#
#_______##################################__________________________##
######################################################################